{
  "id": "arene_jadielle",
  "nom": "Arène de Jadielle",
  "largeur": 10,
  "hauteur": 10,
  "tileset": "indoor",
  "musique": "res://assets/audio/music/arene.ogg",
  "connexions": [],
  "warps": [
    {"id": "sortie", "x": 5, "y": 9, "vers_map": "jadielle_ville", "vers_warp": "arene_entree", "type": "porte"}
  ],
  "pnj": [
    {
      "id": "pnj_arene_jadielle_garde",
      "x": 5, "y": 7,
      "sprite": "pnj_homme",
      "direction": "bas",
      "dialogue": ["L'arène de Jadielle est fermée pour le moment.", "Le champion est absent.", "Revenez plus tard."],
      "mobile": false
    }
  ],
  "objets_sol": [],
  "panneaux": [],
  "tiles_sol": [
    [24, 24, 24, 24, 24, 24, 24, 24, 24, 24],
    [24, 24, 24, 24, 24, 24, 24, 24, 24, 24],
    [24, 24, 29, 29, 29, 29, 29, 29, 24, 24],
    [24, 24, 29, 29, 29, 29, 29, 29, 24, 24],
    [24, 24, 29, 29, 29, 29, 29, 29, 24, 24],
    [24, 24, 29, 29, 29, 29, 29, 29, 24, 24],
    [24, 24, 29, 29, 29, 29, 29, 29, 24, 24],
    [24, 24, 29, 29, 29, 29, 29, 29, 24, 24],
    [24, 24, 29, 29, 29, 29, 29, 29, 24, 24],
    [24, 24, 29, 29, 29, 29, 29, 29, 24, 24]
  ],
  "tiles_objets": [
    [25, 25, 25, 25, 25, 25, 25, 25, 25, 25],
    [25, -1, -1, -1, -1, -1, -1, -1, -1, 25],
    [-1, -1, -1, -1, -1, -1, -1, -1, -1, -1],
    [-1, -1, -1, -1, -1, -1, -1, -1, -1, -1],
    [-1, -1, -1, -1, -1, -1, -1, -1, -1, -1],
    [-1, -1, -1, -1, -1, -1, -1, -1, -1, -1],
    [-1, -1, -1, -1, -1, -1, -1, -1, -1, -1],
    [-1, -1, -1, -1, -1, -1, -1, -1, -1, -1],
    [-1, -1, -1, -1, -1, -1, -1, -1, -1, -1],
    [-1, -1, -1, -1, -1, -1, -1, -1, -1, -1]
  ],
  "tiles_collision": [
    [1, 1, 1, 1, 1, 1, 1, 1, 1, 1],
    [1, 0, 0, 0, 0, 0, 0, 0, 0, 1],
    [0, 0, 0, 0, 0, 0, 0, 0, 0, 0],
    [0, 0, 0, 0, 0, 0, 0, 0, 0, 0],
    [0, 0, 0, 0, 0, 0, 0, 0, 0, 0],
    [0, 0, 0, 0, 0, 0, 0, 0, 0, 0],
    [0, 0, 0, 0, 0, 0, 0, 0, 0, 0],
    [0, 0, 0, 0, 0, 0, 0, 0, 0, 0],
    [0, 0, 0, 0, 0, 0, 0, 0, 0, 0],
    [0, 0, 0, 0, 0, 0, 0, 0, 0, 0]
  ]
}
