{
  "id": "bourg_palette",
  "nom": "Bourg Palette",
  "largeur": 20,
  "hauteur": 18,
  "tileset": "outdoor",
  "musique": "res://assets/audio/music/bourg_palette.ogg",
  "connexions": [
    {"direction": "nord", "vers": "route_1", "decalage": 0}
  ],
  "warps": [
    {"id": "maison_joueur_entree",  "x": 7,  "y": 13, "vers_map": "maison_joueur",     "vers_warp": "sortie",       "type": "porte"},
    {"id": "maison_rival_entree",   "x": 13, "y": 13, "vers_map": "maison_rival",      "vers_warp": "sortie",       "type": "porte"},
    {"id": "laboratoire_entree",    "x": 10, "y": 16, "vers_map": "laboratoire_chen",  "vers_warp": "sortie",       "type": "porte"}
  ],
  "pnj": [
    {
      "id": "pnj_homme_01",
      "x": 5, "y": 10,
      "sprite": "pnj_homme",
      "direction": "bas",
      "dialogue": ["Bourg Palette. Une petite ville tranquille.", "D'ici partent de grands aventuriers !"],
      "mobile": false
    },
    {
      "id": "pnj_femme_01",
      "x": 15, "y": 8,
      "sprite": "pnj_femme",
      "direction": "gauche",
      "dialogue": ["Les Pokémon sauvages vivent dans les hautes herbes.", "Ne t'aventure pas sans les tiens !"],
      "mobile": false
    }
  ],
  "objets_sol": [],
  "panneaux": [
    {"x": 11, "y": 12, "texte": "BOURG PALETTE\n— Une ville aux bords de l'aventure —"}
  ],
  "tiles_sol": [
    [0, 0, 0, 0, 0, 0, 0, 2, 2, 2, 2, 2, 2, 0, 0, 0, 0, 0, 0, 0],
    [0, 0, 0, 0, 0, 0, 0, 2, 2, 2, 2, 2, 2, 0, 0, 0, 0, 0, 0, 0],
    [0, 0, 5, 0, 0, 0, 0, 2, 0, 0, 0, 0, 2, 0, 0, 0, 0, 5, 0, 0],
    [0, 0, 0, 0, 0, 0, 0, 2, 0, 0, 0, 0, 2, 0, 0, 0, 0, 0, 0, 0],
    [0, 0, 0, 0, 0, 0, 0, 2, 0, 0, 0, 0, 2, 0, 0, 0, 0, 0, 0, 0],
    [0, 0, 0, 0, 0, 0, 0, 2, 0, 0, 0, 0, 2, 0, 0, 0, 0, 0, 0, 0],
    [0, 0, 0, 0, 0, 0, 0, 2, 0, 0, 0, 0, 2, 0, 0, 0, 0, 0, 0, 0],
    [0, 0, 0, 0, 0, 0, 0, 2, 0, 0, 0, 0, 2, 0, 0, 0, 0, 0, 0, 0],
    [0, 0, 0, 0, 0, 0, 0, 2, 0, 0, 0, 0, 2, 0, 0, 0, 0, 0, 0, 0],
    [0, 0, 0, 0, 0, 0, 0, 2, 0, 0, 0, 0, 2, 0, 0, 0, 0, 0, 0, 0],
    [0, 0, 0, 0, 0, 2, 2, 2, 0, 0, 0, 0, 2, 2, 2, 0, 0, 0, 0, 0],
    [0, 0, 0, 0, 0, 0, 0, 0, 0, 0, 0, 0, 0, 0, 0, 0, 0, 0, 0, 0],
    [0, 0, 0, 0, 0, 0, 0, 0, 0, 0, 0, 0, 0, 0, 0, 0, 0, 0, 0, 0],
    [0, 0, 0, 0, 0, 0, 0, 2, 0, 0, 0, 0, 2, 0, 0, 0, 0, 0, 0, 0],
    [0, 0, 0, 0, 0, 0, 0, 2, 0, 0, 0, 0, 2, 0, 0, 0, 0, 0, 0, 0],
    [0, 0, 0, 0, 0, 0, 2, 2, 2, 2, 2, 2, 2, 2, 0, 0, 0, 0, 0, 0],
    [0, 0, 0, 0, 0, 0, 2, 2, 2, 2, 2, 2, 2, 2, 0, 0, 0, 0, 0, 0],
    [4, 4, 4, 4, 4, 4, 4, 4, 4, 4, 4, 4, 4, 4, 4, 4, 4, 4, 4, 4]
  ],
  "tiles_objets": [
    [ 8, 10,  8, 10,  8, 10,  8, -1, -1, -1, -1, -1, -1,  8, 10,  8, 10,  8, 10,  8],
    [ 9, 11,  9, 11,  9, 11,  9, -1, -1, -1, -1, -1, -1,  9, 11,  9, 11,  9, 11,  9],
    [ 8, 10, -1, -1, -1, -1, -1, -1, -1, -1, -1, -1, -1, -1, -1, -1, -1, -1, 10,  8],
    [ 9, 11, -1, -1, -1, -1, -1, -1, -1, -1, -1, -1, -1, -1, -1, -1, -1, -1, 11,  9],
    [ 8, 10, -1, -1, -1, -1, -1, -1, -1, -1, -1, -1, -1, -1, -1, -1, -1, -1, 10,  8],
    [ 9, 11, -1, -1, -1, -1, -1, -1, -1, -1, -1, -1, -1, -1, -1, -1, -1, -1, 11,  9],
    [ 8, 10, -1, -1, -1, -1, -1, -1, -1, -1, -1, -1, -1, -1, -1, -1, -1, -1, 10,  8],
    [ 9, 11, -1, -1, -1, -1, -1, -1, -1, -1, -1, -1, -1, -1, -1, -1, -1, -1, 11,  9],
    [ 8, 10, -1, -1, -1, -1, -1, -1, -1, -1, -1, -1, -1, -1, -1, -1, -1, -1, 10,  8],
    [ 9, 11, -1, -1, -1, -1, -1, -1, -1, -1, -1, -1, -1, -1, -1, -1, -1, -1, 11,  9],
    [-1, -1, -1, -1, -1, -1, -1, -1, -1, -1, -1, -1, -1, -1, -1, -1, -1, -1, -1, -1],
    [-1, -1, -1, 16, 17, 17, 18, -1, -1, -1, -1, -1, 16, 17, 17, 18, -1, -1, -1, -1],
    [-1, -1, -1, 19, 23, 20, 21, -1, -1, -1, -1, -1, 19, 23, 20, 21, -1, -1, -1, -1],
    [-1, -1, -1, 19, 20, 22, 21, -1, -1, -1, -1, -1, 19, 20, 22, 21, -1, -1, -1, -1],
    [-1, -1, -1, -1, -1, -1, -1, -1, 16, 17, 17, 18, -1, -1, -1, -1, -1, -1, -1, -1],
    [-1, -1, -1, -1, -1, -1, -1, -1, 19, 23, 23, 21, -1, -1, -1, -1, -1, -1, -1, -1],
    [-1, -1, -1, -1, -1, -1, -1, -1, 19, 20, 22, 21, -1, -1, -1, -1, -1, -1, -1, -1],
    [-1, -1, -1, -1, -1, -1, -1, -1, -1, -1, -1, -1, -1, -1, -1, -1, -1, -1, -1, -1]
  ]
}
