{
  "id": "maison_joueur_2f",
  "nom": "Chambre du joueur",
  "largeur": 8,
  "hauteur": 8,
  "tileset": "indoor",
  "musique": "res://assets/audio/music/bourg_palette.ogg",
  "connexions": [],
  "warps": [
    {
      "id": "escalier_bas",
      "x": 6,
      "y": 5,
      "vers_map": "maison_joueur",
      "vers_warp": "escalier_haut",
      "type": "escalier"
    }
  ],
  "pnj": [],
  "objets_sol": [],
  "panneaux": [],
  "tiles_sol": [
    [24, 24, 24, 24, 24, 24, 24, 24],
    [24, 24, 24, 24, 24, 24, 24, 24],
    [24, 24, 24, 24, 24, 24, 24, 24],
    [24, 24, 24, 24, 24, 24, 24, 24],
    [24, 24, 29, 29, 29, 24, 24, 24],
    [24, 24, 29, 29, 29, 24, 24, 24],
    [24, 24, 24, 24, 24, 24, 24, 24],
    [24, 24, 24, 24, 24, 24, 24, 24]
  ],
  "tiles_objets": [
    [25, 41, 25, 46, 25, 25, 41, 25],
    [25, 32, -1, 35, -1, -1, 34, 25],
    [25, 33, -1, -1, -1, -1, -1, 25],
    [25, -1, -1, -1, -1, -1, -1, 25],
    [25, -1, -1, -1, -1, -1, -1, 25],
    [25, 36, -1, -1, -1, -1, 37, 25],
    [25, -1, -1, -1, -1, -1, -1, 25],
    [25, 25, 25, 25, 25, 25, 25, 25]
  ],
  "tiles_collision": [
    [1, 1, 1, 1, 1, 1, 1, 1],
    [1, 1, 0, 1, 0, 0, 1, 1],
    [1, 1, 0, 0, 0, 0, 0, 1],
    [1, 0, 0, 0, 0, 0, 0, 1],
    [1, 0, 0, 0, 0, 0, 0, 1],
    [1, 1, 0, 0, 0, 0, 0, 1],
    [1, 0, 0, 0, 0, 0, 0, 1],
    [1, 1, 1, 1, 1, 1, 1, 1]
  ]
}
