{
  "id": "route_4",
  "nom": "Route 4",
  "largeur": 20,
  "hauteur": 12,
  "tileset": "outdoor",
  "musique": "res://assets/audio/music/route_1.ogg",
  "connexions": [
    {"direction": "est", "vers": "azuria_ville", "decalage": 0}
  ],
  "warps": [
    {"id": "grotte_sortie", "x": 2, "y": 3, "vers_map": "mont_selenite_b2f", "vers_warp": "sortie_route4", "type": "grotte"}
  ],
  "zones_herbes": [
    {"x1": 5, "y1": 3, "x2": 10, "y2": 7, "table": "route_4"}
  ],
  "pnj": [
    {
      "id": "pnj_route4_01",
      "x": 12, "y": 5,
      "sprite": "pnj_homme",
      "direction": "gauche",
      "dialogue": ["La sortie du Mont Sélénite est derrière toi.", "Azuria est à l'est !"],
      "mobile": false
    }
  ],
  "objets_sol": [
    {"id": "obj_super_potion_r4", "x": 8, "y": 6, "item_id": "super_potion", "quantite": 1}
  ],
  "panneaux": [
    {"x": 3, "y": 2, "texte": "MONT SÉLÉNITE ← SORTIE"},
    {"x": 16, "y": 5, "texte": "AZURIA →"}
  ],
  "tiles_sol": [
    [0, 0, 0, 0, 0, 0, 0, 0, 0, 0, 0, 0, 0, 0, 0, 0, 0, 0, 0, 0],
    [0, 0, 0, 0, 0, 0, 0, 0, 0, 0, 0, 0, 0, 0, 0, 0, 0, 0, 0, 0],
    [0, 0, 0, 0, 0, 0, 0, 0, 0, 0, 0, 0, 0, 0, 0, 0, 0, 0, 0, 0],
    [0, 0, 0, 0, 2, 2, 2, 2, 2, 2, 2, 2, 2, 2, 2, 2, 2, 2, 2, 2],
    [0, 0, 0, 0, 2, 1, 1, 1, 1, 1, 2, 0, 0, 0, 0, 0, 2, 0, 0, 2],
    [0, 0, 0, 0, 2, 1, 1, 1, 1, 1, 2, 0, 0, 0, 0, 0, 2, 0, 0, 2],
    [0, 0, 0, 0, 2, 1, 1, 1, 1, 1, 2, 0, 0, 0, 0, 0, 2, 0, 0, 2],
    [0, 0, 0, 0, 2, 1, 1, 1, 1, 1, 2, 0, 0, 0, 0, 0, 2, 0, 0, 2],
    [0, 0, 0, 0, 2, 2, 2, 2, 2, 2, 2, 2, 2, 2, 2, 2, 2, 2, 2, 2],
    [0, 0, 0, 0, 0, 0, 0, 0, 0, 0, 0, 0, 0, 0, 0, 0, 0, 0, 0, 0],
    [0, 0, 0, 0, 0, 0, 0, 0, 0, 0, 0, 0, 0, 0, 0, 0, 0, 0, 0, 0],
    [0, 0, 0, 0, 0, 0, 0, 0, 0, 0, 0, 0, 0, 0, 0, 0, 0, 0, 0, 0]
  ],
  "tiles_objets": [
    [ 8, 10,  8, 10,  8, 10,  8, 10,  8, 10,  8, 10,  8, 10,  8, 10,  8, 10,  8, 10],
    [ 9, 11,  9, 11,  9, 11,  9, 11,  9, 11,  9, 11,  9, 11,  9, 11,  9, 11,  9, 11],
    [ 8, 10,  6,  7, -1, -1, -1, -1, -1, -1, -1, -1, -1, -1, -1, -1, -1, -1, 10,  8],
    [ 9, 11, -1, -1, -1, -1, -1, -1, -1, -1, -1, -1, -1, -1, -1, -1, -1, -1, -1, -1],
    [-1, -1, -1, -1, -1, -1, -1, -1, -1, -1, -1, -1, -1, -1, -1, -1, -1, -1, -1, -1],
    [-1, -1, -1, -1, -1, -1, -1, -1, -1, -1, -1, -1, -1, -1, -1, -1, -1, -1, -1, -1],
    [-1, -1, -1, -1, -1, -1, -1, -1, -1, -1, -1, -1, -1, -1, -1, -1, -1, -1, -1, -1],
    [-1, -1, -1, -1, -1, -1, -1, -1, -1, -1, -1, -1, -1, -1, -1, -1, -1, -1, -1, -1],
    [-1, -1, -1, -1, -1, -1, -1, -1, -1, -1, -1, -1, -1, -1, -1, -1, -1, -1, -1, -1],
    [ 8, 10, -1, -1, -1, -1, -1, -1, -1, -1, -1, -1, -1, -1, -1, -1, -1, -1, 10,  8],
    [ 9, 11, -1, -1, -1, -1, -1, -1, -1, -1, -1, -1, -1, -1, -1, -1, -1, -1, 11,  9],
    [ 8, 10,  8, 10,  8, 10,  8, 10,  8, 10,  8, 10,  8, 10,  8, 10,  8, 10,  8, 10]
  ]
}
